11111111111111111
1P000000001C11111
100000000C1000001
10000000001111101
100000C0000000001
10000001100000001
100000111000C0001
100C1000000000001
100110000000000E1
11111111111111111